16 12
W	W	W	W	W	W	W	W	W	W	W	W
W	.	.	.	.	.	.	.	.	.	.	W
W	.	.	.	.	.	.	.	.	.	.	W
W	.	M	.	.	.	.	.	.	.	.	W
W	.	.	.	.	.	.	.	.	.	.	W
W	.	.	.	.	.	.	.	.	.	.	W
W	.	.	.	.	.	.	.	.	.	.	W
W	.	.	.	.	.	.	.	.	.	.	W
W	.	.	.	.	.	.	.	.	.	.	W
W	.	.	.	.	.	.	.	.	.	.	W
W	.	.	.	.	.	.	.	.	.	.	W
W	.	.	.	.	.	.	.	.	.	.	W
W	.	.	.	.	.	.	.	.	.	.	W
W	.	.	.	.	.	.	.	.	.	.	W
W	.	.	.	.	.	.	.	.	.	T	W
W	W	W	W	W	W	W	W	W	W	W	W